# # # # # # # # # # # = = = = = = = # # # # # # # # # # # # # # # # # # # # # #
# 0 0 0 0 0 0 0 | 0 0 0 0 0 0 0 0 0 0 0 0 0 0 0 0 0 0 0 0 0 0 0 0 0 0 0 0 0 0 #
# 0 0 0 0 0 0 0 | 0 0 0 0 0 0 0 0 0 0 0 0 0 0 0 0 0 0 0 0 0 0 0 0 0 0 0 0 0 0 #
# 0 0 0 0 0 0 0 | 0 0 0 0 0 0 0 0 0 0 0 0 0 H H H 0 H H H 0 0 0 0 0 0 0 0 0 0 #
# 0 0 0 0 0 0 0 | 0 0 0 0 0 0 0 0 0 0 0 0 0 H 0 H 0 H 0 H 0 0 0 0 0 0 0 0 0 0 #
# 0 0 0 0 0 0 0 > 0 0 0 0 0 0 0 0 0 0 0 0 0 _ _ _ _ _ _ _ 0 0 0 0 0 0 0 0 0 0 #
# _ _ _ _ _ _ _ | 0 0 0 0 0 0 0 0 0 0 0 0 | 0 0 0 0 0 0 0 | 0 0 0 0 0 0 0 0 0 #
# 0 0 0 | 0 0 0 0 0 0 0 0 0 0 0 0 0 0 H H | 0 0 0 0 0 0 0 | H H 0 0 0 0 0 0 0 #
# 0 0 0 | 0 0 0 0 0 0 0 0 0 0 0 0 0 0 H 0 | 0 0 0 0 0 0 0 | 0 H 0 0 0 0 0 0 0 #
# 0 0 0 | 0 0 0 0 0 0 0 0 0 0 0 0 0 0 H H | 0 0 0 0 0 0 0 | H H 0 0 0 0 0 0 0 #
# 0 0 0 | 0 0 0 0 0 0 0 0 0 0 0 0 0 0 0 0 | 0 0 0 0 0 0 0 | 0 0 0 0 0 0 0 0 0 #
# 0 0 0 | 0 0 0 0 0 0 0 0 0 0 0 0 0 0 H H | 0 0 0 0 0 0 0 | H H 0 0 0 0 0 0 0 #
# _ _ _ | 0 0 0 0 0 0 0 0 0 0 0 0 0 0 H 0 | 0 0 0 0 0 0 0 | 0 H 0 0 0 0 0 0 0 #
# 0 0 0 | 0 0 0 0 0 0 0 0 0 0 0 0 0 0 H H | 0 0 0 0 0 0 0 | H H 0 0 0 0 0 0 0 #
# 0 0 0 | 0 0 0 0 0 0 0 0 0 0 0 0 0 0 0 0 | 0 0 0 0 0 0 0 | 0 0 0 0 0 0 0 0 0 #
# 0 0 0 | 0 0 0 0 0 0 0 0 0 0 0 0 0 0 0 0 0 _ _ _ _ _ _ _ 0 0 0 0 0 0 0 0 0 0 #
# _ _ _ | 0 0 0 0 0 0 0 0 0 0 0 0 0 0 0 0 0 0 0 0 0 0 0 0 0 0 0 0 0 0 0 0 0 0 #
# 0 0 0 0 0 0 0 0 0 0 0 0 0 0 0 0 0 0 0 0 0 0 0 0 0 0 0 0 0 0 0 0 0 0 0 0 0 0 #
# 0 0 0 0 0 0 0 0 0 0 0 0 0 0 0 0 0 0 0 0 0 0 0 0 0 0 0 0 0 0 0 0 0 0 0 0 0 0 #
# 0 0 H H H 0 0 0 0 H H H 0 0 0 0 H H H 0 0 0 0 H H H 0 0 0 0 H H H 0 0 0 0 0 #
# 0 0 H 0 H 0 0 0 0 H 0 H 0 0 0 0 H 0 H 0 0 0 0 H 0 H 0 0 0 0 H 0 H 0 0 0 0 0 #
# - - - - - - - - - - - - - - - - - - - - - - - - - - - - - - - - - - - - - - #
# 0 0 0 0 0 0 0 0 0 0 0 0 0 0 0 0 0 0 0 0 0 0 0 0 0 0 0 0 0 0 0 0 0 0 0 0 0 0 #
# 0 0 0 0 0 0 0 0 0 0 0 0 0 0 0 0 0 0 0 0 0 0 0 0 0 0 0 0 0 0 0 0 0 0 0 0 0 0 #
# # # # # # # # # # # # # # # # # # # # # # # # # # # # # # # # # # # # # # # #