# = = = = = = = = = = = = = #
| 0 T R A N Q U A L I T Y 0 |
| 0 0 0 0 0 0 0 0 0 0 0 0 0 |
| 0 0 0 0 0 0 0 0 0 0 0 0 0 |
| 0 0 0 0 0 0 0 0 0 0 0 0 0 |
# 0 H H 0 0 0 0 0 0 0 H H 0 #
# [ 0 H 0 0 0 0 0 0 0 H 0 ] #
# 0 H H 0 0 0 0 0 0 0 H H 0 #
# 0 0 0 0 0 0 0 0 0 0 0 0 0 #
# 0 H H 0 0 0 0 0 0 0 H H 0 #
# [ 0 H 0 0 0 0 0 0 0 H 0 ] #
# 0 H H 0 0 0 0 0 0 0 H H 0 #
# 0 0 0 0 0 0 0 0 0 0 0 0 0 #
# 0 H H 0 0 0 0 0 0 0 H H 0 #
# [ 0 H 0 0 0 0 0 0 0 H 0 ] #
# 0 H H 0 0 0 0 0 0 0 H H 0 #
# 0 0 0 0 0 0 0 0 0 0 0 0 0 #
# 0 H H 0 0 0 0 0 0 0 H H 0 #
# [ 0 H 0 0 0 0 0 0 0 H 0 ] #
# 0 H H 0 0 0 0 0 0 0 H H 0 #
# 0 0 0 0 0 0 0 0 0 0 0 0 0 #
# 0 H H 0 0 0 0 0 0 0 H H 0 #
# [ 0 H 0 0 0 0 0 0 0 H 0 ] #
# 0 H H 0 0 0 0 0 0 0 H H 0 #
# # # # # # # # # # # # # # #