# # # # # # # # # # # # # #
# 0 H H 0 0 0 0 0 0 H H 0 #
# [ 0 H 0 0 0 0 0 0 H 0 ] #
# 0 H H 0 0 0 0 0 0 H H 0 #
# 0 0 0 0 0 0 0 0 0 0 0 0 #
# 0 H H 0 0 0 0 0 0 H H 0 #
# [ 0 H 0 0 0 0 0 0 H 0 ] #
# 0 H H 0 0 0 0 0 0 H H 0 #
# 0 0 0 0 0 0 0 0 0 0 0 0 #
# 0 H H 0 0 0 0 0 0 H H 0 #
# [ 0 H 0 0 0 0 0 0 H 0 ] #
# 0 H H 0 0 0 0 0 0 H H 0 #
# 0 0 0 0 0 0 0 0 0 0 0 0 #
# 0 H H 0 0 0 0 0 0 H H 0 #
# [ 0 H 0 0 0 0 0 0 H 0 ] #
# 0 H H 0 0 0 0 0 0 H H 0 #
# 0 0 0 0 0 0 0 0 0 0 0 0 #
# 0 H H 0 0 0 0 0 0 H H 0 #
# [ 0 H 0 0 0 0 0 0 H 0 ] #
# 0 H H 0 0 0 0 0 0 H H 0 #
| 0 0 0 0 0 0 0 0 0 0 0 0 |
| 0 0 0 0 0 0 0 0 0 0 0 0 |
| 0 0 0 0 0 0 0 0 0 0 0 0 |
| 0 0 S E R E N I T Y 0 0 |
# = = = = = = = = = = = = #