# # # = = = = # # # # # # # # # # # # #
# 0 0 0 0 0 0 0 0 0 0 0 0 0 0 0 0 P P #
# 0 0 0 0 0 0 0 0 0 0 0 0 0 0 0 0 P P #
# 0 0 0 0 0 0 0 0 0 0 0 0 0 0 0 0 P P #
# 0 0 0 0 0 0 0 0 0 0 0 0 0 0 0 0 - - #
# 0 0 0 0 0 0 0 0 0 0 0 0 0 0 0 0 P P #
# 0 0 0 0 0 0 0 0 0 0 0 0 0 0 0 0 P P #
# 0 0 0 0 0 0 0 0 0 0 0 0 0 0 0 0 P P #
# 0 0 0 0 0 0 0 0 0 0 0 0 0 0 0 0 0 0 #
# - - - - - - - - - - 0 0 0 0 0 0 0 0 #
# 0 0 0 0 0 0 0 0 0 | 0 0 0 0 0 0 0 0 #
# H H H 0 0 0 0 0 0 | 0 0 0 0 0 0 0 0 #
# H H H 0 0 0 0 0 0 | 0 0 0 0 0 0 0 0 #
# 0 0 0 0 0 0 0 0 0 | 0 0 0 0 0 0 0 0 #
# - - - - - - - - - - 0 0 0 0 0 0 0 0 #
# 0 0 0 0 0 0 0 0 0 | 0 0 0 0 0 0 0 0 #
# H H H 0 0 0 0 0 0 | 0 0 0 0 0 0 0 0 #
# H H H 0 0 0 0 0 0 | 0 0 0 0 0 0 0 0 #
# 0 0 0 0 0 0 0 0 0 | 0 0 0 0 0 0 0 0 #
# - - - - - - - - - - 0 0 0 0 0 0 0 0 #
# 0 0 0 0 0 0 0 0 0 | 0 0 0 0 0 0 0 0 #
# H H H 0 0 0 0 0 0 | 0 0 0 0 0 0 0 0 #
# H H H 0 0 0 0 0 0 | 0 0 0 0 0 0 0 0 #
# 0 0 0 0 0 0 0 0 0 | 0 0 0 0 0 0 0 0 #
# # # # # # # # # # # # # # # # # # # #
