####################################################################################################
#                                                                                                  #
#                                                                                                  #
#                                                                                                  #
#                                                                                                  #
#                                                                                                  #
#                                                                                                  #
#                                                                                                  #
#                           #########################                                              #
#                           #                       #                                              #
#                           #                                                                      #
#                           #                       #                                              #
#                           #                       #                                              #
#                           #                       #                                              #
#                           ################     ####                                              #
#                                                                                                  #
#                                                                                                  #
#                                                                                                  #
#                                                                                                  #
#                                                                                                  #
#                                                                                                  #
#                                                                                                  #
#                                                                                                  #
#                                                                                                  #
#                                                                                                  #
#                                                        ##########################                #
#                                                        #                        #                #
#                                                        #                        D                #
#                                                        #                        #                #
#                                                        #                        #                #
#                                                                                 #                #
#                                                        ##########################                #
#                                                                                                  #
#                                                                                                  #
#                                                                                                  #
####################################################################################################