####################################################################################################
#                                                                                                  #
#                                                                                                  #
#                                                                                                  #
#                                                                                                  #
#                                                                                                  #
#                                                                                                  #
#                                                                                                  #
#                           #######   ###############                                              #
#                           #                       ######################                         #
#                           #                                            #                         #
#                           #                                            #                         #
#                           #                                            #                         #
#                           #                       #################    #                         #
#                           ################     ####               #    #                         #
#                                                                   #    #                         #
#                                                                   #    #                         #
#                                                                   #    #                         #
#                                                                   #    #                         #
#                                                                   #    #                         #
#                                                                   #    #                         #
#                                                                   #    #                         #
#                                                                   #    #                         #
#                                                                   #    #                         #
#                                                                   #    #                         #
#                                                        ############    ##########                #
#                                                        #                        #                #
#                                                        #                        #                #
#                                                        #                        #                #
#                                                        #                        #                #
#                                                        #                        #                #
#                                                        ##############D###########                #
#                                                                                                  #
#                                                                                                  #
#                                                                                                  #
####################################################################################################